NO textures/eagle.xpm
SO textures/greystone.xpm
WE textures/mossy.xpm
EA textures/wood.xpm

F 102,51,0
C 0,128,255

11111111111111111111111
10000000000E00000000001
11111111111111111101111
10000000000000000000001
10000000001010101000101
10101010101010101000101
11010101010101010100011
10101010101010101010101
11111111111111111111111